111111111111111111111111111111111111111111111
100000000000000000000000000000000000000000001
10W000000000000000000000000000000000000000001
100011100000000000000000000000000000001110001
100011100000000000000000000000000000001110001
100000000000000000000000000000000000000000001
100000000000000000000000000000000000000000001
100000000000000000000010000000000000000000001
100000000000000000000111000000000000000000001
100000000000000000001111100000000000000000001
100000000000000000011111110000000000000000001
100000000000000000001111100000000000000000001
100000000000000000000111000000000000000000001
100000000000000000000010000000000000000000001
100000000000000000000000000000000000000000001
100000000000000000000000000000000000000000001
100011100000000000000000000000000000001110001
100011100000000000000000000000000000001110001
100000000000000000000000000000000000000000001
100000000000000000000000000000000000000000001
111111111111111111111111111111111111111111111
