111111111111111111
100000000000000001
101100110011001101
10000N000000000001
111111111111111111
