1111111111
1000000001
1011001101
10000N0001
1111111111
