11111111111111111111111111111111111111
10000000000000000000000000000000000001
10110011001100000000000000110011001101
10000N00000000000000000000000000000001
11111111111111111100111111111111111111
10000000000000000000000000000000000001
10000000000000000000000000000000000001
10000000000000000000000000000000000001
10000000000000000000000000000000000001
11111111111111111111111111111111111111