111111111111111111111111111
1S1000000000100010000010001
101110111110101010111010101
100010001000001010100010101
111010101111111011101110101
101010100000100000001000101
101010111110111111111011101
101010000010100010000000101
101011101110101010111111101
101010101000101000100000101
101010101010101111101110101
100010101010101000001010001
101110101011101011111011101
101000001000001010100000101
101110111111101010101110101
100010001000101010100010101
111011111010111010111010101
100000000010000010000010001
111111111111111111111111111
