111111111111111111111111111111111
100000000000000000000000000000001
101000100010001000100010001000101
100000000000000000000000000000001
100000000000000000000000000000001
101000100010001000100010001000101
100000000000000000000000000000001
100000000000000000000000000000001
10E000100010001000100010001000101
100000000000000000000000000000001
100000000000000000000000000000001
101000100010001000100010001000101
100000000000000000000000000000001
100000000000000000000000000000001
101000100010001000100010001000101
100000000000000000000000000000001
111111111111111111111111111111111
