111111111111111111111111111
1N0000000000000000000000001
111111111111111111111111101
111000000000000000000000101
101111111111111111111110101
101110000000000000000010101
101011111111111111111010101
101011100000000000001010101
101010111111111111101010101
101010111000000000101010101
101010101111111110101010101
101010101110000010101010101
101010101011111010101010101
101010101011101010101010101
101010101010111010101010101
101010101010000010101010101
101010101011111110101010101
101010101000000000101010101
101010101111111111101010101
101010100000000000001010101
101010111111111111111010101
101010000000000000000010101
101011111111111111111110101
101000000000000000000000101
101111111111111111111111101
100000000000000000000000001
111111111111111111111111111
